# Comentarios iniciales
#
#
#
10 10
0000000000
0000200000
0000000000
0000000000
1111111110
0000000000
0000000000
0000000000
0000000000
0000000040