# Comentarios iniciales
#
#
#
20 20
01111111110000000000
01111111110000000000
01111111110000000000
01111111110000000000
01111111110000000000
01111111110000000000
01111111110000000000
01111111110000000000
01111101110000000000
01111111110000000000
01111111110000033300
01111112110000000400
01000011110000000000
01111111110000000000
01101111110000000000
01111111110000100000
01111111110000000000
01111111110000000000
01111111110000000400
01111111110000000000
